111111111111111
1E1000000000001
100000010000001
1000000C000Z001
100001111100001
10P011000110001
101C000C000C101
100011000110001
100001111100001
100Z000C0000001
10000001000Z001
100000Z000001E1
111111111111111