1111111111111111111111111111
1E1000000001C0000101C0000001
1010101011011101010010011101
1C1C101CC100100101100011C101
1010101CC100C0110CC01001C0P1
1C1C101CC100100101100011C101
1010101101011101010010011101
100010000001C0000101C0000001
1111111111111111111111111111