111111111111111111111111111111
1E10000000000Z0000000000000001
100000010000000000000010000001
1000000C0000000000000000000001
100001111100001110011111000001
10P0110Z0110000000010ZC0000001
101C000C000C100C00011111110001
1000110001100000000000C0010001
100001111100001110000111110001
1000000C0000000000000000000001
100000Z10000000000000010000001
1000000000000000000000000001E1
111111111111111111111111111111