1111111111111111111111111111111111111111111
1P00000000000000000000000000000000000000001
1011100111001110000010100100110011110011001
1010010100101001000110100101001010000100101
1010010100101001001010110101000010000010001
101110C1110C1110C0E11C1011C1011C1110C001001
1010000100101001010010100101001010000100101
1010000100101001010010100100110011110011001
1000000000000000000000000000000000000000001
1111111111111111111111111111111111111111111